1
11
6
7 7 7 7 7 7 7 7 7 7 7
1 1 1 1 1 1 1 1 1 1 1
2 2 2 2 2 2 2 2 2 2 2
3 3 3 3 3 3 3 3 3 3 3
4 4 4 4 4 4 4 4 4 4 4
5 5 5 5 5 5 5 5 5 5 5
2
11
17
0 0 2 0 0 0 0 0 2 0 0
0 0 2 0 0 0 0 0 2 0 0
0 0 0 2 0 0 0 2 0 0 0
0 0 0 2 0 0 0 2 0 0 0
0 0 7 7 7 7 7 7 7 0 0
0 0 7 7 7 7 7 7 7 0 0
0 7 7 1 7 7 7 1 7 7 0
0 7 7 1 7 7 7 1 7 7 0
7 7 7 7 7 7 7 7 7 7 7
7 7 7 7 7 7 7 7 7 7 7
7 7 7 7 7 7 7 7 7 7 7
7 0 7 7 7 7 7 7 7 0 7
7 0 7 0 0 0 0 0 7 0 7
7 0 7 0 0 0 0 0 7 0 7
7 0 7 0 0 0 0 0 7 0 7
0 0 0 7 7 0 7 7 0 0 0
0 0 0 7 7 0 7 7 0 0 0
3
11
15
0 0 6 0 0 6 0 0 6 0 0
0 0 0 0 0 0 0 0 0 0 0
0 0 7 0 0 0 0 0 7 0 0
0 1 2 7 0 0 0 7 3 4 0
7 2 3 4 5 0 2 3 4 5 7
7 3 4 5 1 2 3 4 5 1 7
0 4 5 1 2 3 4 5 1 2 0
0 0 1 2 3 6 5 1 2 0 0
0 0 2 3 4 5 1 2 3 0 0
1 0 0 4 5 1 2 3 0 0 1
0 0 0 5 1 2 3 4 0 0 0
0 0 0 0 2 3 4 0 0 0 0
0 0 0 0 0 4 0 0 0 0 0
0 0 0 0 0 0 0 0 0 0 0
0 1 0 0 0 6 0 0 0 1 0
4
13
11
1 1 1 1 1 1 1 1 1 1 1 1 1
0 0 0 0 0 0 0 0 0 0 0 0 0
2 2 2 6 6 6 6 6 6 6 6 6 6
0 0 0 0 0 0 0 0 0 0 0 0 0
3 3 3 3 3 3 3 3 3 3 3 3 3
0 0 0 0 0 0 0 0 0 0 0 0 0
6 6 6 6 6 6 6 6 6 6 4 4 4
0 0 0 0 0 0 0 0 0 0 0 0 0
5 5 5 5 5 5 5 5 5 5 5 5 5
0 0 0 0 0 0 0 0 0 0 0 0 0
1 1 1 6 6 6 6 6 6 6 6 6 6